11
3 2
1 2 2 3
6 9
3 5 2 6 4 2 6 3 3 1 3 4 6 1 5 1 1 4 
12 12
10 12 8 7 1 7 10 3 6 7 9 5 7 10 11 7 4 11 12 5 2 12 10 4 
46 45
32 10 7 26 5 29 15 45 13 38 5 27 24 41 46 23 12 25 22 21 44 42 40 15 17 34 17 37 27 43 10 25 16 27 13 2 43 8 22 15 17 1 17 4 8 3 36 39 36 6 30 5 40 44 39 4 18 39 1 29 36 15 16 12 38 26 24 13 28 43 41 19 17 33 7 42 11 13 13 31 46 43 6 14 2 35 9 6 35 20 
75 74
34 42 3 26 3 65 15 25 10 75 73 60 59 21 63 23 19 3 74 21 39 44 18 36 28 6 39 53 3 50 3 1 44 50 74 48 12 7 29 58 31 69 1 57 18 68 48 12 15 26 63 36 64 75 21 71 11 9 62 36 72 18 11 26 66 45 71 25 45 26 27 20 47 42 29 19 2 60 44 40 26 13 11 52 11 33 44 34 40 10 8 62 16 38 28 75 5 54 3 38 49 72 71 51 53 17 6 2 62 22 37 48 4 71 39 14 63 30 41 33 54 11 8 75 61 4 56 16 62 55 11 32 20 37 43 22 35 8 14 67 56 31 70 9 46 29 24 73 
108 111
41 56 45 18 60 54 93 51 103 42 35 96 54 102 69 58 73 26 21 23 7 98 28 73 65 45 32 59 64 94 40 60 72 45 78 84 58 29 52 76 37 28 2 54 4 82 38 77 3 69 93 54 31 39 45 107 43 66 100 47 25 101 68 1 48 108 19 26 34 101 89 52 12 74 35 85 52 99 3 32 74 52 6 86 101 9 12 37 15 84 94 51 93 25 17 15 27 38 22 5 10 107 5 44 70 42 53 49 90 35 55 49 65 69 59 71 52 87 22 46 68 22 83 35 31 47 35 94 94 33 61 77 27 94 55 104 3 60 1 41 1 6 53 41 21 43 11 75 72 42 37 24 5 52 106 86 1 95 46 3 48 104 88 22 62 45 81 70 82 87 107 30 39 34 79 89 14 4 106 98 13 40 21 106 16 40 11 102 8 32 62 80 97 41 50 51 78 31 57 73 36 34 11 20 63 31 105 56 91 24 67 56 46 92 103 73 60 107 70 69 51 102 
158 158
132 44 18 44 149 35 117 79 96 3 122 132 17 71 145 118 1 134 26 124 106 6 104 116 35 27 59 157 27 8 91 139 122 47 104 65 30 115 57 79 49 19 107 154 21 28 16 60 37 144 94 157 17 113 19 134 152 51 110 55 56 2 46 2 3 123 92 145 59 137 81 105 110 141 131 156 61 66 146 89 67 61 123 152 119 149 131 89 114 53 56 99 105 22 18 158 54 140 32 143 63 155 44 102 143 36 30 25 105 37 102 22 85 143 134 155 23 58 110 90 110 9 67 32 129 48 139 35 103 56 100 44 99 4 36 121 97 120 91 120 4 114 74 128 41 10 81 151 41 105 149 100 37 104 2 132 127 67 111 149 45 60 135 67 135 130 60 6 155 93 38 94 129 25 15 56 57 20 19 127 135 76 3 72 71 99 131 42 101 139 84 81 128 48 1 98 29 121 37 67 150 95 86 111 104 30 66 152 93 82 92 21 11 26 68 89 57 158 75 113 136 132 94 55 29 150 90 156 101 141 39 50 116 21 3 140 64 48 76 13 114 60 148 99 83 143 70 2 68 14 12 87 138 133 69 121 24 86 118 154 11 132 129 50 64 133 131 108 32 31 40 157 43 153 53 153 5 53 109 82 157 112 88 18 23 26 82 126 80 124 34 25 73 137 54 77 53 52 138 33 110 62 51 125 116 78 142 133 56 87 128 7 147 68 112 98 
206 205
191 163 190 120 20 109 136 151 194 94 61 82 47 126 162 62 6 189 196 99 155 80 83 166 5 172 112 26 32 52 182 55 112 99 86 142 2 84 27 202 109 116 72 105 64 19 203 54 27 2 145 99 8 161 128 129 118 39 23 72 54 163 94 201 192 95 9 80 177 206 174 118 41 111 95 54 27 164 32 197 45 43 5 51 58 8 117 142 98 154 102 74 113 145 147 18 52 113 165 176 169 57 64 165 9 192 9 55 84 93 172 206 48 155 102 179 49 156 54 3 60 16 153 61 196 60 41 1 175 169 42 151 18 10 185 178 179 184 181 60 55 18 159 70 41 176 32 29 152 156 14 16 109 24 174 99 102 76 59 58 27 143 178 9 115 118 41 151 46 206 152 153 166 15 49 188 137 81 18 127 182 115 158 30 152 133 26 97 134 23 141 115 170 67 121 100 67 61 184 204 55 130 159 172 120 194 176 34 133 182 8 18 184 106 177 126 156 83 63 150 140 88 89 78 57 157 25 121 6 20 1 17 65 82 141 168 100 149 159 186 34 143 110 206 164 172 189 87 165 153 180 4 164 131 59 149 77 45 89 172 143 144 6 187 156 134 113 187 39 173 35 108 153 66 85 59 101 55 35 192 30 59 83 135 145 53 199 192 148 87 179 18 163 120 103 18 114 86 60 167 22 39 98 87 190 12 187 169 152 180 75 34 33 198 143 122 49 90 129 154 50 114 162 182 171 117 30 13 117 35 185 104 67 77 44 192 96 4 203 205 185 92 157 140 87 7 48 198 183 147 21 164 13 107 68 177 136 139 200 26 156 56 195 180 79 161 21 36 38 19 82 125 138 76 100 150 139 71 181 81 140 11 194 160 37 179 140 132 90 31 179 124 64 193 168 28 40 19 77 119 91 158 146 109 123 135 153 73 136 69 
250 252
9 150 89 246 232 171 107 22 119 172 9 158 148 233 239 123 224 157 207 190 157 96 102 174 119 51 98 87 92 157 11 64 152 131 95 244 242 246 79 200 206 15 36 228 125 205 107 168 228 56 103 37 219 199 230 162 240 9 241 26 161 133 90 47 201 113 123 30 173 87 28 54 227 171 86 153 2 148 186 194 73 167 217 79 12 126 89 47 190 45 57 77 153 9 89 22 87 109 28 129 230 198 50 31 246 129 63 177 220 178 92 48 36 232 157 185 205 20 210 207 172 196 216 17 111 248 86 191 178 50 6 137 139 176 144 128 131 238 56 233 4 1 5 40 239 216 9 61 191 50 248 208 205 55 238 236 250 43 114 113 183 234 102 130 138 34 101 115 184 108 219 211 219 209 142 233 188 185 250 202 120 84 7 193 141 88 13 61 71 86 164 116 148 178 25 135 54 34 129 37 125 235 76 100 213 235 125 43 5 73 56 164 213 224 85 161 123 54 148 73 1 88 168 7 182 198 6 237 108 100 41 149 236 198 85 93 226 247 106 79 89 93 179 46 243 38 7 18 54 44 6 147 110 175 105 216 240 207 210 243 250 176 37 62 148 119 14 228 213 147 160 92 131 91 35 166 37 24 167 95 237 38 167 144 200 222 95 28 36 201 91 36 76 119 169 7 42 226 37 231 217 221 135 248 79 187 24 115 162 41 1 5 234 17 108 179 200 175 156 192 241 83 109 247 218 208 235 247 240 177 65 101 27 73 130 52 165 108 71 39 63 145 62 181 59 41 203 230 119 170 8 35 210 122 143 90 2 35 130 109 187 220 49 203 33 66 80 24 64 133 141 67 239 70 10 102 75 234 60 215 23 42 53 66 61 218 225 223 190 192 169 225 134 242 246 19 16 225 3 97 217 82 145 241 127 28 206 19 17 194 3 167 47 146 152 77 154 185 44 74 33 107 147 211 37 112 118 183 67 117 94 146 116 197 84 141 68 130 4 180 69 214 118 212 217 32 159 215 215 195 85 21 239 72 159 123 121 71 163 166 204 236 89 58 3 155 189 158 71 132 78 95 157 69 99 35 140 124 29 199 12 227 110 81 209 229 170 124 104 193 136 91 170 245 151 159 243 249 104 66 48 74 216 250 
262 263
206 184 111 116 123 19 79 153 92 120 33 44 208 87 44 107 112 257 65 243 201 17 243 68 70 120 124 211 262 170 154 68 3 162 226 70 157 231 209 214 142 28 36 95 212 87 177 262 30 188 249 79 20 218 9 160 34 132 69 161 63 22 168 46 104 3 210 42 262 167 113 145 250 140 27 143 25 182 41 191 174 188 184 123 48 71 174 139 78 28 116 36 36 5 25 82 55 3 126 54 126 30 59 123 214 30 80 35 137 55 221 63 140 195 59 102 21 52 174 256 154 211 136 87 93 179 140 226 252 18 47 115 129 42 218 101 141 163 124 130 141 125 247 103 94 41 181 6 178 111 202 236 35 199 96 201 67 64 171 91 125 139 196 128 51 146 250 155 199 154 149 138 111 80 94 81 248 227 186 213 83 221 153 175 7 154 81 231 204 247 221 149 144 228 146 227 84 64 73 139 100 212 34 39 239 134 31 142 56 103 51 73 68 112 173 260 180 121 237 207 150 45 162 159 40 99 54 234 100 22 46 13 50 196 2 231 149 205 21 181 48 136 114 122 52 3 106 170 146 60 93 163 261 32 33 230 147 213 195 130 121 25 22 33 79 131 125 5 231 224 69 242 81 100 140 172 53 235 107 262 27 256 258 70 164 229 8 92 172 142 93 61 86 43 259 108 117 260 110 15 89 50 197 141 239 200 90 72 9 151 45 231 56 182 34 218 212 204 25 183 170 188 204 102 218 107 54 240 229 7 250 118 164 131 239 119 10 101 101 134 151 111 121 193 253 40 261 58 108 39 99 178 38 133 133 39 261 89 171 102 242 194 57 170 108 53 55 210 69 95 230 162 207 194 119 14 127 225 249 173 128 217 219 218 218 225 232 204 217 191 113 49 209 114 70 109 228 241 88 58 238 212 30 246 129 148 254 220 64 231 7 47 85 140 199 23 170 233 135 145 181 169 75 3 216 207 83 11 179 222 176 91 46 124 254 25 32 198 86 51 96 238 42 215 241 87 178 156 202 113 1 252 129 213 255 151 62 158 194 135 4 77 16 10 65 15 18 260 146 158 207 185 72 259 258 98 100 165 159 105 187 142 240 245 97 148 135 4 62 251 171 24 190 27 26 4 183 166 6 244 138 29 207 203 37 226 235 74 197 12 66 50 192 77 223 144 219 76 152 28 71 189 260 239 54 140 
297 299
75 67 252 213 282 132 214 234 168 117 80 70 133 203 65 219 21 125 230 287 62 261 277 288 84 38 246 117 129 122 5 4 150 71 195 109 122 221 59 214 64 275 165 232 293 165 107 208 114 255 154 137 27 189 246 71 26 293 31 130 135 279 66 98 27 146 92 113 207 221 96 141 215 55 20 142 295 83 150 196 105 201 199 35 115 142 250 19 156 9 150 10 207 53 45 284 8 62 223 155 136 34 293 93 74 86 107 163 211 17 84 186 260 42 295 63 53 215 278 236 138 179 176 123 205 239 200 50 116 113 172 272 68 144 168 202 6 238 95 272 82 211 246 241 266 292 73 114 141 286 268 194 49 48 74 256 158 34 48 133 102 134 213 115 37 125 176 267 100 219 48 259 121 2 223 85 33 206 152 90 247 25 203 14 89 181 64 202 42 235 35 290 218 134 49 36 224 141 72 165 24 21 118 295 242 96 185 265 59 102 117 272 112 77 81 188 21 159 295 206 286 123 202 286 258 197 183 12 268 137 152 50 78 157 32 100 86 19 81 190 205 267 63 164 73 129 71 9 82 236 102 283 39 112 24 60 101 279 289 179 209 228 1 178 65 286 287 93 174 150 189 33 211 120 69 118 11 272 225 15 139 156 194 65 91 281 27 175 290 50 291 247 290 195 235 134 293 142 182 152 208 81 90 294 95 134 234 17 143 46 263 154 90 78 72 43 238 152 82 213 212 186 28 273 39 131 124 102 227 144 57 156 146 244 269 100 143 243 108 255 270 148 30 191 38 99 54 136 26 53 212 294 27 226 16 122 222 9 77 202 187 224 196 280 221 173 62 195 48 27 46 87 25 19 6 234 61 125 179 186 135 98 205 158 217 103 148 236 143 1 197 199 61 161 196 151 28 276 253 8 242 265 149 227 19 264 251 201 177 136 271 89 133 153 70 204 162 120 144 257 167 107 94 268 105 142 170 209 14 246 103 50 161 144 184 222 171 32 147 283 34 166 158 18 140 104 265 143 169 41 74 180 38 204 244 74 66 34 111 133 163 53 268 245 198 101 16 296 52 296 249 231 223 149 89 58 153 24 116 130 249 3 288 81 110 112 4 84 249 134 15 23 88 259 47 85 87 7 76 102 69 220 273 268 193 228 92 249 239 91 126 5 237 168 132 12 51 226 104 82 284 286 227 15 12 218 297 283 100 240 283 106 53 128 96 29 228 10 192 297 263 271 229 105 233 68 285 3 214 41 53 145 216 90 143 121 248 95 254 128 274 53 33 44 248 191 154 13 100 56 67 60 122 292 53 79 97 160 210 215 88 160 240 40 149 22 38 119 245 262 232 127 176 94 90 183 37 180 