5
5
1 0 0 0 0
0 1 1 1 0
1 1 0 0 0
1 0 1 1 1
0 0 1 0 1
9
0 0 1 1 1 1 1 1 1
0 0 1 0 0 0 0 1 1
1 0 1 0 1 0 0 0 1
1 1 1 1 1 0 1 0 1
0 0 1 0 0 1 1 0 0
0 0 0 0 1 1 0 0 0
0 1 1 0 0 0 0 1 0
1 0 1 0 0 1 0 1 0
1 1 1 0 0 1 1 1 1
17
1 1 0 0 0 0 0 0 1 1 0 0 0 0 0 0 0
0 1 1 0 0 0 0 1 1 1 0 0 0 0 0 0 0
0 0 0 0 0 0 1 1 0 0 1 1 0 0 0 0 0
0 0 0 0 0 1 1 0 0 0 0 1 1 0 0 0 0
0 0 0 0 1 1 0 0 0 0 0 0 1 1 0 0 0
0 0 0 1 1 0 0 0 0 0 0 0 0 1 1 0 0
0 0 1 1 0 0 0 1 1 1 1 0 0 0 1 1 0
0 1 1 0 0 0 0 1 0 0 1 0 0 0 1 1 0
1 1 0 0 0 0 0 1 0 0 1 0 0 0 0 1 1
0 1 1 0 0 0 0 1 1 1 1 0 0 0 0 1 1
0 0 1 0 0 0 0 0 0 0 0 0 0 0 1 1 0
0 0 0 1 1 0 0 0 0 0 0 0 0 1 1 0 0
0 0 0 0 1 0 0 0 0 0 0 0 1 1 0 0 0
0 0 0 0 0 1 1 0 0 0 0 1 1 0 0 0 0
0 0 0 0 0 0 1 1 0 0 1 1 0 0 1 1 0
0 1 0 0 0 0 0 1 1 1 1 0 0 0 1 1 0
0 1 0 0 0 0 0 0 1 1 0 0 0 0 0 0 0
7
0 1 1 0 0 0 0
0 1 1 0 1 0 0
1 1 1 0 1 0 1
0 0 0 0 1 1 1
1 0 0 0 0 0 0
0 1 1 1 1 1 0
0 1 0 1 1 0 0
5
0 1 0 0 0
0 1 0 0 0
0 1 0 0 0
0 0 0 0 0
0 0 0 0 0
